
169	107	107	61	169	62	169	62	107	63	169	107	169	107	169	107	169	107	169	107	169	107	107	20	107	21	107	22	107	23	169	107	169	107	169	107	169	107	169	107	169	107	169	107	169	107	169	107	169	107	169	107	169	107	169	107	169	107	169	107	169	107	169	107	169	107	107	53	107	54	107	55	107	147	107	148	107	148	107	149	107	169	107	169	107	169	107	169	107	169	107	169	107	169	107	169	107	169	107	113	131	169	131	169	131	169	131	169	131	130	131	169	131	169	131	145	131	169	131	169	131	169	131	169	131	148	131	148	131	148	124	148	124	148	124	148	124	148	124	149	124	169	124	169	124	169	124	169	124	169	124	169	124	169	124	169	124	169	124	169	124	169	124	169	124	169
169	107	169	107	107	68	107	69	107	70	169	107	169	107	169	107	169	107	169	107	107	36	107	37	107	38	107	39	169	107	169	107	169	107	107	113	107	114	107	114	107	114	107	114	107	114	107	114	107	114	107	114	107	115	169	107	169	107	169	107	169	107	169	107	169	107	107	169	107	71	107	72	107	73	169	107	169	107	169	107	107	169	107	169	107	169	107	169	107	169	107	169	107	169	107	169	107	169	107	130	131	169	131	169	131	169	131	169	131	147	131	148	131	148	131	148	131	148	131	148	131	148	131	149	131	169	131	169	124	132	124	169	124	169	124	169	124	169	124	169	124	169	124	169	124	169	124	169	124	169	124	169	124	169	124	169	124	169	124	169	124	169	124	169	124	169
169	107	169	107	169	107	107	86	107	87	169	107	169	107	169	107	169	107	169	107	107	53	107	54	107	55	169	107	169	107	107	113	107	114	169	164	169	131	169	131	169	131	169	131	169	131	169	131	169	131	169	131	169	131	107	114	107	115	169	107	169	107	169	107	169	107	107	169	107	88	107	89	107	90	169	107	169	107	169	107	107	169	107	169	107	169	107	169	107	169	107	169	107	169	107	169	107	169	107	130	131	169	131	169	131	111	131	112	131	169	131	169	131	169	131	169	131	169	131	118	131	135	131	113	131	114	131	114	131	114	124	114	124	114	124	114	124	114	124	115	124	169	124	169	124	169	124	169	124	110	124	78	124	79	124	79	124	79	124	80	124	169	124	169	124	169
169	107	169	107	169	107	107	113	107	114	107	114	107	115	169	107	169	107	169	107	107	41	107	71	107	41	107	41	107	113	169	164	169	131	169	131	169	131	169	131	169	131	169	131	169	131	169	131	169	131	169	131	169	131	169	131	107	132	169	107	169	107	169	107	169	107	107	169	107	105	107	106	107	169	169	107	169	107	169	107	107	169	107	169	107	169	107	169	107	169	107	169	107	169	107	169	107	169	107	130	131	169	131	169	131	41	131	129	131	169	131	78	131	79	131	79	131	79	131	79	131	79	131	79	131	79	131	79	131	79	131	79	131	79	131	79	131	79	131	79	124	79	124	79	124	79	124	79	124	79	45	95	45	169	45	169	45	169	124	97	124	169	124	169	124	169
169	107	169	107	169	107	107	130	169	131	169	131	107	132	169	107	107	101	107	41	169	107	107	88	107	106	169	107	107	130	131	131	169	131	131	27	169	28	169	28	169	28	169	28	169	28	169	28	169	28	169	28	131	29	107	148	107	132	169	107	169	107	169	107	169	107	107	169	107	122	107	123	107	169	169	107	107	25	107	26	107	169	107	41	107	169	107	169	107	41	107	169	107	169	107	41	107	169	107	41	131	169	131	169	131	169	131	169	131	93	45	95	131	45	131	45	131	45	131	45	45	169	45	169	45	169	45	169	45	169	45	169	45	169	45	169	45	169	45	169	45	169	45	169	45	169	45	169	45	169	45	169	45	169	45	169	45	169	124	97	124	169	124	169	124	169
169	107	169	107	169	107	107	130	169	131	131	27	169	28	169	28	169	28	107	29	169	107	107	105	107	106	169	107	107	27	169	28	169	28	169	45	169	45	169	45	169	45	169	45	169	45	169	45	169	45	169	45	169	45	169	28	107	29	169	107	169	107	107	82	107	84	107	138	107	139	107	140	107	134	107	25	107	26	107	43	107	169	107	169	107	169	107	169	107	169	107	169	107	169	107	169	107	169	107	130	131	41	131	41	131	169	131	169	45	95	45	95	131	45	131	45	131	45	131	45	45	169	45	169	45	169	45	169	45	169	45	169	45	169	45	169	45	169	45	169	45	169	45	169	45	169	45	169	45	169	45	169	45	169	45	169	45	169	127	97	127	169	127	169	127	169
169	107	169	8	169	8	169	9	169	28	169	45	169	45	169	45	169	45	127	46	169	127	169	127	169	127	169	127	127	44	169	45	169	45	169	45	169	45	169	45	169	45	169	45	169	45	169	45	169	45	169	45	169	45	92	27	169	28	107	28	107	28	107	28	107	28	107	28	107	28	107	28	107	28	107	28	107	28	107	29	107	169	107	169	107	169	107	169	107	169	107	169	107	169	107	169	107	169	107	130	131	169	131	169	131	169	131	93	45	113	45	114	45	114	45	115	131	45	131	45	45	169	45	169	45	169	45	169	45	169	45	169	45	169	45	169	45	169	45	169	45	169	45	169	45	169	45	169	45	169	45	169	45	169	45	169	45	169	144	97	144	169	144	169	144	169
169	107	169	45	169	45	169	45	169	45	169	45	169	45	169	45	169	45	144	46	169	144	169	144	169	144	169	144	144	44	169	45	169	45	169	45	169	45	169	45	169	45	169	45	169	45	169	45	169	45	169	45	169	45	92	44	169	45	107	45	107	45	107	45	107	45	107	45	107	45	107	45	107	45	107	45	107	45	107	46	107	169	107	169	107	169	107	169	107	169	107	169	107	169	107	169	107	169	107	130	131	169	131	169	131	169	131	95	45	130	131	169	131	169	45	132	131	45	131	45	45	169	45	169	45	169	45	169	45	169	45	169	45	169	45	169	45	169	45	169	45	169	45	169	45	169	45	169	45	169	45	169	45	169	45	169	45	169	144	97	144	169	144	169	144	169