169 107  107 061  169 062  169 062  107 063  169 107  169 107  169 107  169 107  169 107  169 107  107 020  107 021  107 022  107 023  169 107  169 107  169 107  169 107  169 107  169 107  169 107  169 107  169 107  169 107  169 107  169 107  169 107  169 107
169 107  169 107  107 068  107 069  107 070  169 107  169 107  169 107  169 107  169 107  107 036  107 037  107 038  107 039  169 107  169 107  169 107  107 113  107 114  107 114  107 114  107 114  107 114  107 114  107 114  107 114  107 115  169 107  169 107
169 107  169 107  169 107  107 086  107 087  169 107  169 107  169 107  169 107  169 107  107 053  107 054  107 055  169 107  169 107  107 113  107 114  169 164  169 131  169 131  169 131  169 131  169 131  169 131  169 131  169 131  169 131  107 114  169 107
169 107  169 107  169 107  107 113  107 114  107 114  107 115  169 107  169 107  169 107  107 041  107 071  107 041  107 041  107 113  169 164  169 131  169 131  169 131  169 131  169 131  169 131  169 131  169 131  169 131  169 131  169 131  169 131  169 107
169 107  169 107  169 107  107 130  169 131  169 131  107 132  169 107  107 101  107 041  169 107  107 088  107 106  169 107  107 130  169 131  169 131  131 027  169 028  169 028  169 028  169 028  169 028  169 028  169 028  169 028  131 029  169 131  169 107
169 107  169 107  169 107  107 130  169 131  131 027  169 028  169 028  169 028  107 029  169 107  107 105  107 106  169 107  107 027  169 028  169 028  169 045  169 045  169 045  169 045  169 045  169 045  169 045  169 045  169 045  169 045  169 028  169 107
169 107  169 008  169 008  169 009  169 028  169 045  169 045  169 045  169 045  127 046  169 127  169 127  169 127  169 127  127 044  169 045  169 045  169 045  169 045  169 045  169 045  169 045  169 045  169 045  169 045  169 045  169 045  169 045  169 107
169 107  169 045  169 045  169 045  169 045  169 045  169 045  169 045  169 045  144 046  169 144  169 144  169 144  169 144  144 044  169 045  169 045  169 045  169 045  169 045  169 045  169 045  169 045  169 045  169 045  169 045  169 045  169 045  169 107